#################
# +         #   #
#         #     #
########  #     #
#         #     #
#   #####  ##   #
### ##       -  #
###   #         #
### ####  #     #
#    #    #     #
#################

